################################################################
#..............................................................#
#............................######............................#
#..............###########.....................................#
#..............#.........#.....................................#
#..............#.........#.............##########..............#
#..............#.........#.............#........#..............#
#..............#.........#########.....#........#..............#
#..............#..................#....#........#..............#
#..............###########........#....##########..............#
#..............................................................#
#..............................................................#
################################################################