############################################################################################################################################
#..........................................................................................................................................#
#.......#.......#.......#.......#.......#.......#.......#.......#.......#.......#.......#.......#.......#.......#.......#.......#.......#..#
#..........................................................................................................................................#
#.....#.......#.......#.......#.......#.......#.......#.......#.......#.......#.......#.......#.......#.......#.......#.......#.......#....#
#..........................................................................................................................................#
#..........................................................................................................................................#
#..........................................................................................................................................#
#.#.......#.......#.......#.......#.......#.......#.......#.......#.......#.......#.......#.......#.......#.......#.......#.......#........#
#..........................................................................................................................................#
#.......#.......#.......#.......#.......#.......#.......#.......#.......#.......#.......#.......#.......#.......#.......#.......#.......#..#
#..........................................................................................................................................#
#..........................................................................................................................................#
#..........................................................................................................................................#
#...#.......#.......#.......#.......#.......#.......#.......#.......#.......#.......#.......#.......#.......#.......#.......#.......#......#
#..........................................................................................................................................#
#.#.......#.......#.......#.......#.......#.......#.......#.......#.......#.......#.......#.......#.......#.......#.......#.......#........#
#..........................................................................................................................................#
#..........................................................................................................................................#
#..........................................................................................................................................#
#.....#.......#.......#.......#.......#.......#.......#.......#.......#.......#.......#.......#.......#.......#.......#.......#.......#....#
#..........................................................................................................................................#
#...#.......#.......#.......#.......#.......#.......#.......#.......#.......#.......#.......#.......#.......#.......#.......#.......#......#
#..........................................................................................................................................#
#..........................................................................................................................................#
#..........................................................................................................................................#
#.......#.......#.......#.......#.......#.......#.......#.......#.......#.......#.......#.......#.......#.......#.......#.......#.......#..#
#..........................................................................................................................................#
#.....#.......#.......#.......#.......#.......#.......#.......#.......#.......#.......#.......#.......#.......#.......#.......#.......#....#
#..........................................................................................................................................#
#..........................................................................................................................................#
#..........................................................................................................................................#
#.#.......#.......#.......#.......#.......#.......#.......#.......#.......#.......#.......#.......#.......#.......#.......#.......#........#
#..........................................................................................................................................#
#.......#.......#.......#.......#.......#.......#.......#.......#.......#.......#.......#.......#.......#.......#.......#.......#.......#..#
#..........................................................................................................................................#
#..........................................................................................................................................#
#..........................................................................................................................................#
#...#.......#.......#.......#.......#.......#.......#.......#.......#.......#.......#.......#.......#.......#.......#.......#.......#......#
#..........................................................................................................................................#
#.#.......#.......#.......#.......#.......#.......#.......#.......#.......#.......#.......#.......#.......#.......#.......#.......#........#
#..........................................................................................................................................#
#..........................................................................................................................................#
#..........................................................................................................................................#
#.....#.......#.......#.......#.......#.......#.......#.......#.......#.......#.......#.......#.......#.......#.......#.......#.......#....#
#..........................................................................................................................................#
#...#.......#.......#.......#.......#.......#.......#.......#.......#.......#.......#.......#.......#.......#.......#.......#.......#......#
#..........................................................................................................................................#
#..........................................................................................................................................#
#..........................................................................................................................................#
#.......#.......#.......#.......#.......#.......#.......#.......#.......#.......#.......#.......#.......#.......#.......#.......#.......#..#
#..........................................................................................................................................#
#.....#.......#.......#.......#.......#.......#.......#.......#.......#.......#.......#.......#.......#.......#.......#.......#.......#....#
#..........................................................................................................................................#
#..........................................................................................................................................#
#..........................................................................................................................................#
#.#.......#.......#.......#.......#.......#.......#.......#.......#.......#.......#.......#.......#.......#.......#.......#.......#........#
#..........................................................................................................................................#
#.......#.......#.......#.......#.......#.......#.......#.......#.......#.......#.......#.......#.......#.......#.......#.......#.......#..#
#..........................................................................................................................................#
#..........................................................................................................................................#
#..........................................................................................................................................#
#...#.......#.......#.......#.......#.......#.......#.......#.......#.......#.......#.......#.......#.......#.......#.......#.......#......#
#..........................................................................................................................................#
#.#.......#.......#.......#.......#.......#.......#.......#.......#.......#.......#.......#.......#.......#.......#.......#.......#........#
#..........................................................................................................................................#
#..........................................................................................................................................#
#..........................................................................................................................................#
#.....#.......#.......#.......#.......#.......#.......#.......#.......#.......#.......#.......#.......#.......#.......#.......#.......#....#
#..........................................................................................................................................#
#...#.......#.......#.......#.......#.......#.......#.......#.......#.......#.......#.......#.......#.......#.......#.......#.......#......#
#..........................................................................................................................................#
#..........................................................................................................................................#
#..........................................................................................................................................#
#.......#.......#.......#.......#.......#.......#.......#.......#.......#.......#.......#.......#.......#.......#.......#.......#.......#..#
#..........................................................................................................................................#
#.....#.......#.......#.......#.......#.......#.......#.......#.......#.......#.......#.......#.......#.......#.......#.......#.......#....#
#..........................................................................................................................................#
#..........................................................................................................................................#
#..........................................................................................................................................#
#.#.......#.......#.......#.......#.......#.......#.......#.......#.......#.......#.......#.......#.......#.......#.......#.......#........#
#..........................................................................................................................................#
#.......#.......#.......#.......#.......#.......#.......#.......#.......#.......#.......#.......#.......#.......#.......#.......#.......#..#
#..........................................................................................................................................#
#..........................................................................................................................................#
#..........................................................................................................................................#
#...#.......#.......#.......#.......#.......#.......#.......#.......#.......#.......#.......#.......#.......#.......#.......#.......#......#
#..........................................................................................................................................#
#.#.......#.......#.......#.......#.......#.......#.......#.......#.......#.......#.......#.......#.......#.......#.......#.......#........#
############################################################################################################################################