################################################################
#..............................................................#
#..............................................................#
#..............................................................#
#..............................................................#
#..............................................................#
#..............................................................#
#..............................................................#
#..............###########.....................................#
#..............#.........#.....................................#
#..............#.........#.............##########..............#
#..............#.........#.............#........#..............#
#..............#.........#.............#........#..............#
#..............#.........#.............#........#..............#
#..............###########.............##########..............#
#..............................................................#
#..............................................................#
#..............................................................#
#..............................................................#
#..............................................................#
#..............................................................#
#..............................................................#
################################################################